.#.............
.#.############
.#.#....#......
.#.#.##.#.##.#.
......#.##.#.#.
#####.#....#.#.
....#.#.#.##.#.
.####.#.#..#.#.
....#.#.##.#.#.
###..##..#...#.
.......#...#.#.